与	giving
両	Both
丸	circle
乗	Square
予	Preliminary
争	dispute
互	each other
亡	deceased
交	intercourse
他	other
付	attached
令	decree
仲	relationship
件	subject
任	appointed
伝	Tradition
似	Similar
位	rank
余	the rest
例	example
供	accompaniment
便	flights
係	clerk
信	Faith
倉	storehouse
倍	times
倒	overthrow
候	weather
値	value
偉	great
停	stop 
健	Ken
側	~ side
偶	even
備	preparation
働	work
億	hundred million
優	excellent
兆	Trillion
光	light
児	child
全	all
公	public
共	Both
兵	soldiers
具	tool
典	Law
内	within
最	highest
冷	cold
処	place
刀	sword
列	column
初	first time
判	Judgment
利	profit
到	Arrive
制	system
刷	printing
刻	hour
副	deputy
割	Split
功	success
加	addition
助	Help
努	Tsutomu
労	Labor
勇	courage
務	duty
勝	win
勤	work
包	package
化	transformation
卒	graduation
協	cooperative
単	single
博	Hiroshi
印	mark
危	danger
原	original
参	three
反	anti
収	collection
取	taking
受	receive
史	history
号	issue
司	Tsukasa
各	each
合	combination
向	direction
君	you
否	no
吸	suction
吹	blowing
告	Notice
周	lap
呼	call
命	life
和	sum
唱	chant
商	quotient
喜	Joy
器	vessel
回	times
因	cause
困	need
囲	enclosure
固	Fixed
園	garden
在	present
坂	Slope
型	type
報	report
塩	salt
増	increase
士	samurai
声	voice
変	strange
夢	dreams
太	fat
夫	husband
央	Central
失	lost
好	Good
妻	wife
委	Committee
娘	Daughter
婚	marriage
婦	wife
存	existing
季	season
孫	grandchild
宅	home
守	Mamoru
完	finish
官	official
定	fixed
実	fruit
客	guest
宮	palace
害	harm
容	Capacity
宿	inn
寄	close
富	wealth
寒	cold
寝	sleeping
察	Guess
寺	temple
対	versus
局	bureau
居	residence
岩	rock
岸	shore
島	island
州	state
巣	nest
差	difference
市	city
希	Nozomi
師	teacher
席	seat
帯	band
帳	book
常	always
平	flat
幸	Happiness
幾	Iku
底	bottom
府	prefecture
座	seat
庫	warehouse
庭	garden
康	health
式	formula
弓	bow
引	draw
当	this
形	shape
役	role
彼	he
径	Diameter
徒	non-adult
得	get
御	control
必	Must
忘	forget
忙	busy
念	just in case
怒	anger
怖	fear
性	sex
恐	Fear
恥	shame
息	breath
悲	sorrow
情	affection
想	idea
愛	Love
感	feeling
慣	practice
成	formed
戦	battle
戸	door
戻	return
所	place
才	Talent
打	hit
払	payment
投	Throw
折	folding
抜	pull out
抱	embrace
押	push
招	invitation
拾	pick up
指	finger
挙	performance
捕	caught
掛	Hanging
探	search
支	branch
改	Kai
放	release
政	politics
救	Salvation
敗	defeat
散	scatter
数	number
整	adjustment
断	break
旗	flag
易	Easy
昔	long ago
星	Star
昨	last
昭	Akira
晩	night
景	view
晴	fine weather
暗	dark
暮	evening
曲	song
更	change
望	Desire
期	period
未	not yet
末	end
札	tag
材	material
束	bundle
杯	cup
松	pine
板	board
果	fruit
柱	pillar
栄	Sakae
根	root
格	rank
案	plan
梅	plum
械	machine
植	Plant
極	very
構	structure
様	looks
標	mark
権	rights
横	beside
橋	bridge
機	machine
欠	Lack
次	Next
欲	greed
歯	teeth
歳	age
歴	history
残	remaining
段	step
殺	killing
毒	poison
毛	hair
氏	Mr
民	people
氷	ice
求	request
決	decision
汽	steam
油	oil
治	cure
法	law
波	wave
泣	crying
泳	swimming
洗	washing
活	activity
流	flow
浅	Shallow
浮	floating
浴	bath
消	extinguish
深	deep
清	Qing
済	Already
渡	delivery
温	temperature
港	port
湖	lake
湯	hot water
満	Full
漁	fishing
演	acting
灯	light
炭	charcoal
点	point
無	Nothing
然	Yes
焼	baked
煙	smoke
照	light
熱	heat
牧	Maki
犯	criminal
状	letter
猫	Cat
玉	ball
王	king
現	present
球	ball
産	production
由	reason
申	Monkey
畑	field
留	station
番	number
疑	suspicion
疲	tired
痛	pain
登	climbing
的	target
皆	all
皮	leather
皿	plate
盗	steal
直	straight
相	phase
省	Ministry
眠	sleep
矢	arrow
石	stone
破	broken
確	sure
示	Show
礼	gratitude
祖	ancestor
祝	celebration
神	God
票	vote
祭	Festival
福	Fortune
科	Department
秒	seconds
程	about
種	seed
積	product
突	thrust
窓	window
童	child
競	competition
竹	bamboo
笑	smile
笛	whistle
第	No.
筆	writing brush
等	etc
節	section
算	Calculate
管	tube
箱	box
米	rice
粉	powder
精	spirit
糸	thread
紀	era
約	about
級	class
細	thin
組	set
経	Sutra
結	tie
給	salary
絵	picture
絶	Absolute
続	Sequel
緑	green
緒	string
線	line
練	kneading
罪	sin
置	place
羊	sheep
美	beauty
羽	wing
老	old man
耳	ear
職	job
育	upbringing
胃	stomach
背	back
能	Noh
脈	pulse
腸	intestine
腹	stomach
臣	vassal
舞	dance
航	navigation
船	ship
良	good
芸	art
芽	bud
若	Young
苦	suffering
草	grass
荷	load
落	drop
葉	leaf
薬	medicine
虫	insect
血	blood
術	jutsu
街	city
衣	clothes
表	table
要	required
規	rules
覚	Awakening
観	view
角	corner
解	Solution
訓	lesson
記	Record
訪	visit
許	Huh
詩	poetry
認	approval
誤	mistake
説	theory
誰	Who
課	Division
調	tone
談	story
論	theory
識	consciousness
警	police
議	discussion
谷	valley
豆	beans
象	elephant
貝	shellfish
負	negative
財	wealth
貧	poverty
貨	currency
責	responsibility
貯	savings
費	expense
資	capital
賛	Praise
賞	award
越	Pass
路	road
身	Body
軍	army
輪	ring
辞	address
農	agriculture
辺	side
込	included
迎	welcoming
返	return
迷	hesitation
追	addition
退	withdraw
逃	escape
途	way
速	speed
連	Communicating
進	advancement
遅	late
遊	play
過	excess
達	reached
違	difference
遠	Far
適	Suitable
選	selection
郡	county
部	Department
都	capital
配	delivery
酒	Liquor
里	village
量	amount
鉄	iron
録	record
鏡	mirror
閉	closed
関	Seki
阪	Osaka
降	fall
限	limit
除	remove
陸	land
険	dangerous
陽	sun
隊	corps
階	floor
際	edge
雑	rough
難	difficulty
雪	snow
雲	cloud
静	stillness
非	non
面	surface
靴	shoes
章	chapter
頂	top
順	order
頭	Head
頼	reliance
顔	face
願	wishes
類	kind
飛	flight
養	nourishment
首	neck
馬	Horse
髪	hair
鳴	ringing
麦	wheat
黄	yellow
鼻	nose
